W,W,W,W,W,W,W,W,W,W,W,W,W,W,W,W,W,W,W,W,W,W,W,W,W
W,,,,,,,,,,,,,,,,,,,,,,,,W
W,,,,,,,,,,,,,,,,,,,,,,,,W
W,,,,,,,,,,,,,,,,,,,,,,,,W
W,,,,,,,,,,,,,,,,,,,,,,,,W
W,S,,,,,,,,,,,,,,,,,,,,,,T,W
W,,,,,,,,,,,,,,,,,,,,,,,,W
W,,,,,,,,,,,,,,,,,,,,,,,,W
W,,,,,,,,,,,,,,,,,,,,,,,,W
W,,,,,,,,,,,,,,,,,,,,,,,,W
W,,,,,,,,,,,,,,,,,,,,,,,,W
W,W,W,W,W,W,W,W,W,W,W,W,W,W,W,W,W,W,W,W,W,W,W,W,W
