W,W,W,W,W,W,W,W,W,W,W,W,W,W,W,W
W,,,,,,,m_001,,,,,,,,W
W,S,,,,,,,,,,,,,,W
W,,,,,,cab_001,cab_001,cab_001,,,,,,,W
W,,,,,,,,,,,,,,,W
W,,,,,,,,,,  ,,,,T,W
W,,,,,pc_001L,pc_001R,,,,,,,,,W
W,W,W,W,W,W,W,W,W,W,W,W,W,W,W,W
